File is 1338667701.rlg327
                                                                                
                                                                                
           .......                                                              
 ......    .......                #############################                 
 ......    .......   ..............              #           ###                
 ......    .......   ..............              #           # ##               
 ......    .......###..............              ........ ....  #####.....      
 ......####.......   ..............              ........ ....       .....      
      #    .......   ..............              ........ ....       .....      
      #    .......   ..............              ........ ....       .....      
      #              ..............              ........ ....       .....      
 ......              ..............#             ........ ....       .....      
 ......                            #             ........ ....       .....      
 ......                            .....         ........ ....       .....      
 ......#################           .....                 ################       
 ......                #####       .....                 #                      
 ......                    ##                           ##                      
 ......                     #############################                       
 ......                                                                         
                                                                                
                                                                                
File is 1341033552.rlg327
                                                                                
                                                      .....                     
            ....                                      .....                     
            ....####                                  #                         
               #   ##########.........                #                         
               #             .........                #                         
               #               #  ##################################            
               #               #                      #            ##           
               #               #                      #             #....       
               #               #                      #              ....       
               #               #             ......   #              ....       
               #               #             ......   #         #####....       
               ###           ..............  ......##########....               
                 #           ..............  ......          ....               
                 ####....####..............##......                             
                     ....                    ......                             
                     ....                    ......                             
                     ....                    ......                             
                     ....                                                       
                                                                                
                                                                                
File is 1342211968.rlg327
                                                                                
                      #######################                                   
                      #                     #..............                     
                #######                     #..............                     
               ##                           #..............                     
               #                            #..............                     
               #                            #..............#####.....           
               #                            #..............     .....           
               #                            #..............     .....           
               #                            #..............      #              
               #                            #    #               #              
               #                            #    #               #              
       #########                            #    #               #              
       #                                    #    #               #              
     ....                                   #    #               #              
     ....                         #############.........         .........      
     ....                      ####         #  .........         .........      
     ....##########           ##            #  .........         .........      
                  #############             #  .........           #            
                                            ########################            
                                                                                
File is 1343124832.rlg327
                                                                                
                                                                                
    ............###....                .....                                    
    ............   ....                .....     ########################       
    ............   ....                #       ###                      ##      
         #  #######....#########################                         #      
         #         ....                #                 ....            #      
         #         ....                #                 ....#####       #      
         #                             #                         #.......#      
         #                             #                          .......#      
         #                             #                          .......#      
         #                             ........                  ##     ##      
         #......                       ........                 ##      ##      
          ......                       ........####........######       ##      
          ......                       ........    ........             ##      
          ......#######################........                         ##      
                                       ........                         #....   
                                       ........                          ....   
                                                                         ....   
                                                                                
                                                                                
File is 1344566786.rlg327
                                                                                
                                                 #######........  ###########   
                                                ##      ........# #       ....  
                                                #               ###      #....  
                                            .....                ###     #      
 .............                              .....            ######......#      
 .............                              .....            #     ......       
 .............##############################.....#############     ......       
             #                                 #                   ......       
             #                          ..............             ......       
             #                          ..............             ......       
             #                                  #                ##......       
             #                                  #                #              
             ######..........             ...........         ....              
                   ..........             ...........         ....              
                   ..........             ...........                           
                   ..........             ...........                           
                   ..........            #...........                           
                   ..........#############                                      
                                                                                
                                                                                
File is 1345750038.rlg327
                                                                                
                                                ..............                  
                                                ..............                  
                                                ..............                  
                                                ..............                  
                                                ..............                  
  ......                                        ..............                  
  ......          ##############################..............                  
  ......         ##       .....                 ..............                  
  ......        ##      ##.....                 #                               
  ......#########       #                       #                               
  ......#################                       #                               
                        #                       #                               
                        #                       #                               
                        #                       #                               
                        ##                   ......                             
                         ##     .........####......                             
                          ######.........    ......                             
                                             ......                             
                                                                                
                                                                                
File is 1346664318.rlg327
                                                                                
                #############                                                   
               ##           #      ......                                       
               #            #######......                                       
              ##    ..............#......#####....                              
             ##     ..............#......     ....                              
   ###########      ..............#......        ##                             
  ..........        ..............#......         #    ####                     
  ..........        ..............#......         ........#                     
  ..........        ..............#......         ........#                     
  ..........    ####..............#######         ........#                     
  ..........    #                       ##        ........#                     
  ..........  ###                        ###      ........#                     
  ..........###                            ################                     
  ..........                                                                    
                                                                                
                                                                                
                                                                                
                                                                                
                                                                                
                                                                                
File is 1347581119.rlg327
                                                                                
                        ......                                   ....           
                        ......##########                         ....           
           ....         ......         #                         ....           
           ....#########......         #                         ....           
           ....         ......         #                           #            
           ....         ......         #####........####           #            
    .....##....                             ........   #           #            
    .....                                              ......      #            
    .....##########################                    ......      ....         
    .....                         #                    ......      ....         
    .....                         ##                   ......######....         
    .....                          #           ########......############       
    .....                          ##         ##                      #.....    
                                    ##        #                        .....    
                                     ##########                        .....    
                                                                                
                                                                                
                                                                                
                                                                                
                                                                                
File is 1348505419.rlg327
                                                                                
                                                                                
                                                                                
                                                                                
              #####################                                             
    ###########         ........  #                                             
    #....               ........  ########## ....                               
    #....################      #           ##....                               
     ....                      ########   ###....                               
     ....                             ##### ##                                  
                                       #     ###                                
                                       ##      #######                          
                                        #            ##                         
                                        #         .............                 
                                        ##########.............                 
                                                      ##                        
                                                    ....                        
                                                    ....                        
                                                                                
                                                                                
                                                                                
File is 1349343970.rlg327
                                                                                
                                                                                
                                           .....                      #######   
                                           .....                      #.....#   
            ........                       .....                      #.....#   
            ........                ....   .....                      #.....#   
            ........                ....   .....###............       #.....    
            ........              ##....###.....   ............    ####.....    
            ........            ### #              ............   ##   .....    
            ........            #   #              ............ ###    .....    
          ##........         ....   #              ............##      .....    
     .....# ........         ....   #              ............#       #        
     .....         #         ....   ........       ............#########        
     .....         #         #      ........                  ##                
     .....#        #         #      ........                  #                 
     .....####     ##.........                                #                 
     .....   ##      .........                                #                 
     .....    ##     .........                                #                 
     .....     ###   .........                               ##                 
                 #############################################                  
                                                                                
